10 10 8 3
1111111111
1000000001
1000000001
1000P32001
1000000001
1000000001
1000000001
1000000001
1000000001
1111111111
