17 17 8 2
NNNNNNN1111NNNNNN
NNNN1111001NNNNNN
NNN11001001NNNNNN
NNN10050301NNNNNN
N1110130001111NNN
N1603001130001NNN
N10010P0501031NNN
N1001000000301111
N1901111311000001
N1031422221010001
N1003222820310111
110014222210001NN
100011101111111NN
1033001001NNNNNNN
1001000001NNNNNNN
1111110001NNNNNNN
NNNNN11111NNNNNNN
