8 9 8 3
NN11111N
1110001N
12P3001N
1110321N
1211301N
10102011
13000301
10002001
11111111
