22 11 8 3
NNNN11111NNNNNNNNNNNNN
NNNN10001NNNNNNNNNNNNN
NNNN13001NNNNNNNNNNNNN
NN111003111NNNNNNNNNNN
NN100300301NNNNNNNNNNN
11101011101NNNNN111111
1000101110111111100221
1030030000000000000221
111110111101P111100221
NNNN1000000111NN111111
NNNN1111111NNNNNNNNNNN
