17 10 8 3
NNNNNNNN11111111N
NNNNNNNN100000P1N
NNNNNNNN10313011N
NNNNNNNN1030031NN
NNNNNNNN1130301NN
11111111103010111
12222001103003001
11222000030030001
12222001111111111
11111111NNNNNNNNN
