14 10 8 3
111111111111NN
12200100000111
12200103003001
12200131111001
1220000P011001
12200101003011
11111101130301
NN103003030301
NN100001000001
NN111111111111
