22 13 8 3
NNNNNNNNNNNNNN11111111
NNNNNNNNNNNNNN10022221
NNN1111111111110022221
NNN1000010030300022221
NNN1033313003010022221
NNN1003000003010022221
NNN1033013030311111111
111100301000001NNNNNNN
100010111111111NNNNNNN
1000030011NNNNNNNNNNNN
10331330P1NNNNNNNNNNNN
1000100011NNNNNNNNNNNN
111111111NNNNNNNNNNNNN
