15 7 8 3
N111111111NNNNN
1100060001NNNNN
103507000111111
109006640490201
100596000111101
1100060000900P1
N11111111111111
