14 10 8 3
111111111111NN
1224460000011N
17229105005011
10420191111001
10420090P01011
11000101003001
N1171131130301
NN105003050301
NN100001000001
NN111111111111
