17 10 8 3
NNNNNNNN11111111N
NNNNNNNN100000P1N
NNNNNNNN10913011N
NNNNNNNN1030031NN
NNNNNNN11930301NN
11111111003010111
12422500605003001
11224997790030001
11222001111111111
11111111NNNNNNNNN
