22 13 8 3
NNNNNNNNNNNNNNNNNNNNNN
NNNNNNNNNNNNNN11111111
NNN1111111111119922221
NNN1000010050907922221
NNN1053313003000922221
NNN1003000005010924441
NNN1033013030511167671
1111003010000010000001
1000101111111119999991
1000030011200909009001
10331330P1400000090991
1000100011200000000001
1111111111111111111111
